111111111111111111111111
111111111111111111111111
1111111CCCCCCCCCC1111111
1111111C11111111C1111111
1111111C10011001C1111111
1111111C10011001C1111111
1111111C11100111C1111111
1111111C11000011C1111111
1111111C11011011C1111111
1111111C11011011C1111111
1111111CCCCCCCCCC1111111
111111111111111111111111
1P0000000C000000000E0001
11100000000000C000000111
111111111111111111111111
